Mending - Wither
Unbreaking - Evoker
Aqua Affinity - 
Blast Protection - Ghast
Depth Strider - 
Feather Falling - Phantom
Fire Protection - Strider
Frost Walker - Stray
Projectile Protection - 
Protection - Iron Golem
Respiration - Drowned
Soul Speed - Wraith
Thorns - Guardian
Bane of Arthropods - Spider
Breach - Shulker
Fire Aspect - Magma Cube
Looting - 
Knockback - Ravager
Sharpness - Piglin Brute
Smite - Skeleton Horse
Sweeping Edge - Sword Piglin
Channeling - Charged Creeper
Flame - Blaze
Impaling - Trident Drowned
Infinity - Skeleton
Loyalty - 
Riptide - Elder Guardian
Multishot - Pillager
Piercing - Crossbow Piglin
Power - 
Punch - 
Quick Charge - Breeze
Efficiency - Creeper
Fortune - 
Luck of the Sea - Pufferfish
Lure - Tropical Fish
Silk Touch - Silverfish